GeoID,Date,Estimate; Total:,Margin of Error; Total:,"Estimate; Housing units with a mortgage, contract to purchase, or similar debt:","Margin of Error; Housing units with a mortgage, contract to purchase, or similar debt:","Estimate; Housing units with a mortgage, contract to purchase, or similar debt: - With either a second mortgage or home equity loan, but not both:","Margin of Error; Housing units with a mortgage, contract to purchase, or similar debt: - With either a second mortgage or home equity loan, but not both:","Estimate; Housing units with a mortgage, contract to purchase, or similar debt: - With either a second mortgage or home equity loan, but not both: - Second mortgage only","Margin of Error; Housing units with a mortgage, contract to purchase, or similar debt: - With either a second mortgage or home equity loan, but not both: - Second mortgage only","Estimate; Housing units with a mortgage, contract to purchase, or similar debt: - With either a second mortgage or home equity loan, but not both: - Home equity loan only","Margin of Error; Housing units with a mortgage, contract to purchase, or similar debt: - With either a second mortgage or home equity loan, but not both: - Home equity loan only","Estimate; Housing units with a mortgage, contract to purchase, or similar debt: - Both second mortgage and home equity loan","Margin of Error; Housing units with a mortgage, contract to purchase, or similar debt: - Both second mortgage and home equity loan","Estimate; Housing units with a mortgage, contract to purchase, or similar debt: - No second mortgage and no home equity loan","Margin of Error; Housing units with a mortgage, contract to purchase, or similar debt: - No second mortgage and no home equity loan",Estimate; Housing units without a mortgage,Margin of Error; Housing units without a mortgage
6001,31/12/2005,298774,6294,233793,5811,71729,3852,15029,2304,56700,3263,4360,959,157704,5766,64981,3550
6007,31/12/2005,47434,2224,30634,2022,9241,1191,1451,532,7790,1136,388,267,21005,2066,16800,1439
6013,31/12/2005,256205,5089,203039,5033,70057,3847,16159,2793,53898,3239,2996,745,129986,5433,53166,2614
6017,31/12/2005,47998,2135,35737,1876,11243,1513,2479,908,8764,1173,381,235,24113,1749,12261,1554
6019,31/12/2005,157789,4439,115773,4375,26775,2279,7813,1660,18962,1863,2026,859,86972,4355,42016,2940
6023,31/12/2005,29520,1528,17660,1381,4818,946,736,327,4082,834,703,506,12139,1408,11860,1154
6025,31/12/2005,26044,1778,17252,1457,1873,570,926,365,947,401,461,426,14918,1457,8792,1159
6029,31/12/2005,145321,4991,106031,4141,21900,2130,6657,1442,15243,1541,798,439,83333,4092,39290,2831
6031,31/12/2005,21101,1317,14741,1504,2649,770,837,393,1812,647,127,136,11965,1434,6360,878
6033,31/12/2005,19164,1732,11467,1618,1541,646,472,318,1069,547,406,474,9520,1405,7697,1367
6037,31/12/2005,1562853,17727,1208550,16837,314847,9956,76950,5726,237897,7336,25544,2794,868159,15626,354303,8676
6039,31/12/2005,28120,1934,19777,1852,5051,1077,1525,564,3526,993,212,241,14514,1527,8343,996
6041,31/12/2005,67253,2696,49829,2500,17994,1923,1439,538,16555,1883,640,538,31195,2311,17424,1862
6045,31/12/2005,21238,1711,11933,1406,3123,1032,798,459,2325,883,212,178,8598,1257,9305,1196
6047,31/12/2005,42329,2309,30228,2123,5355,1027,1567,541,3788,797,825,570,24048,1991,12101,1222
6053,31/12/2005,68664,2945,50422,2852,14516,1931,2145,694,12371,1759,837,515,35069,2970,18242,1488
6055,31/12/2005,32323,1865,22802,1753,7530,1103,1280,627,6250,1105,160,205,15112,1726,9521,1164
6057,31/12/2005,28888,1824,19332,1609,7006,1144,1008,501,5998,960,150,166,12176,1520,9556,1250
6059,31/12/2005,601038,8161,470919,7972,140793,5129,24039,2466,116754,4881,7540,1463,322586,7971,130119,4367
6061,31/12/2005,85499,3359,65895,3447,24891,2134,5151,1048,19740,2033,1054,460,39950,3183,19604,1714
6065,31/12/2005,434872,8719,333623,8818,94617,5437,29508,3507,65109,4170,6087,1409,232919,8376,101249,3844
6067,31/12/2005,300975,6108,233524,5941,70602,4510,17279,2064,53323,4290,4694,1184,158228,5874,67451,3333
6071,31/12/2005,383061,8033,301738,7455,62947,3961,17595,2769,45352,3002,5327,1256,233464,7754,81323,3896
6073,31/12/2005,605855,9464,463882,9150,141796,5292,24878,2758,116918,4393,7045,1397,315041,8678,141973,4737
6075,31/12/2005,122603,4341,85560,3739,22937,2479,3028,806,19909,2221,913,443,61710,3262,37043,2675
6077,31/12/2005,129522,3815,101175,3727,25476,2271,7433,1458,18043,1839,1428,529,74271,3878,28347,2069
6079,31/12/2005,64077,2752,45652,2747,13907,1682,2741,1031,11166,1489,647,424,31098,2420,18425,1919
6081,31/12/2005,158672,4079,117527,4386,40732,3344,6476,1342,34256,2879,1602,465,75193,4263,41145,2394
6083,31/12/2005,79553,2759,56337,2735,19207,2408,2265,703,16942,2217,945,554,36185,2424,23216,1692
6085,31/12/2005,349388,7404,269769,7539,83850,4626,15662,2038,68188,4008,6554,1426,179365,6791,79619,3588
6087,31/12/2005,55676,2686,40302,2662,15495,1739,1941,647,13554,1678,665,292,24142,2381,15374,1558
6089,31/12/2005,44986,1865,30074,1970,8473,1027,2156,688,6317,839,539,308,21062,1847,14912,1367
6095,31/12/2005,90074,2954,73478,2885,23313,2118,6425,1119,16888,1876,884,479,49281,2693,16596,1704
6097,31/12/2005,113484,3889,84766,3400,28348,2418,5642,1190,22706,2102,962,460,55456,2889,28718,2388
6099,31/12/2005,100836,3462,76698,3154,20435,2214,6170,1250,14265,1743,1136,547,55127,3005,24138,1818
6101,31/12/2005,19429,1224,13638,1138,4531,1068,1581,721,2950,822,67,106,9040,1085,5791,901
6107,31/12/2005,71243,2497,51118,2458,11423,1308,3926,922,7497,1050,1219,546,38476,2326,20125,1598
6111,31/12/2005,174154,4423,138637,4436,45156,2678,8594,1543,36562,2432,3442,1206,90039,4014,35517,2251
6113,31/12/2005,36348,1829,26625,1797,8994,1264,2549,822,6445,1118,625,511,17006,1740,9723,1114
6115,31/12/2005,12909,1449,8372,1367,1854,548,562,356,1292,472,49,84,6469,1198,4537,782
6001,31/12/2006,296733,4773,232569,4679,81602,3348,15012,1689,66590,3212,5195,1072,145772,4821,64164,3152
6007,31/12/2006,51211,1957,32678,2233,9851,1336,2074,603,7777,1211,253,195,22574,1993,18533,1599
6013,31/12/2006,258877,4662,207360,4511,73416,3613,15234,2022,58182,3268,4076,1101,129868,4486,51517,2743
6017,31/12/2006,49224,1868,38404,1930,14231,1446,3263,886,10968,1390,531,402,23642,1669,10820,1171
6019,31/12/2006,152363,3959,114231,3551,28920,1979,6737,1249,22183,1890,3068,896,82243,3423,38132,2339
6023,31/12/2006,28751,1568,17197,1467,4787,814,800,350,3987,774,298,220,12112,1314,11554,1266
6025,31/12/2006,27196,2081,19212,1873,2668,708,1269,493,1399,544,426,355,16118,1795,7984,1214
6029,31/12/2006,147483,4000,111990,3877,29710,2005,9788,1355,19922,1539,1086,515,81194,3509,35493,2362
6031,31/12/2006,22372,1540,16676,1396,4723,932,1559,692,3164,688,520,439,11433,1237,5696,921
6033,31/12/2006,16167,1927,9512,1542,1893,727,695,509,1198,548,135,158,7484,1330,6655,1365
6037,31/12/2006,1564640,11710,1219070,12583,348744,8973,86729,4507,262015,7562,29187,2645,841139,10563,345570,6915
6039,31/12/2006,25064,1844,18093,1715,3631,975,1098,628,2533,662,353,324,14109,1587,6971,986
6041,31/12/2006,65129,2319,47367,2297,17764,2048,3177,1060,14587,1818,1011,523,28592,2456,17762,1815
6045,31/12/2006,21429,1452,12592,1397,2096,505,570,299,1526,443,205,337,10291,1275,8837,1224
6047,31/12/2006,38913,2209,27288,2296,5425,936,1462,391,3963,790,1132,742,20731,2223,11625,1291
6053,31/12/2006,68716,2531,50021,2789,16973,1816,3582,951,13391,1526,1254,658,31794,2081,18695,1647
6055,31/12/2006,29915,1619,20706,1694,7243,1239,1847,776,5396,1021,130,141,13333,1606,9209,1100
6057,31/12/2006,29191,1931,19643,1657,7042,1234,310,276,6732,1154,43,78,12558,1461,9548,1296
6059,31/12/2006,605615,6967,474101,7649,152238,5213,29823,2695,122415,4568,9438,1757,312425,7190,131514,4485
6061,31/12/2006,89272,2523,68151,2502,24504,2047,4620,1080,19884,1835,1211,482,42436,2331,21121,1735
6065,31/12/2006,444836,6011,338553,6134,99120,4217,33432,2586,65688,3362,5251,1263,234182,6502,106283,3679
6067,31/12/2006,306047,6029,244003,6011,81834,4319,22807,2247,59027,3364,4891,1030,157278,5176,62044,3047
6071,31/12/2006,393257,6526,311681,6264,75492,3136,28508,2192,46984,2450,6503,1693,229686,6120,81576,3953
6073,31/12/2006,599242,8305,460541,8017,154751,5400,38518,3246,116233,4140,9918,1723,295872,6963,138701,4039
6075,31/12/2006,126712,4349,87731,3812,23472,2222,3860,874,19612,2119,1082,422,63177,3562,38981,2330
6077,31/12/2006,132481,3772,101335,3950,28394,2343,8337,1228,20057,1925,1752,730,71189,3592,31146,2155
6079,31/12/2006,60654,2209,42695,2256,11997,1144,2047,646,9950,1099,758,437,29940,2088,17959,1608
6081,31/12/2006,159025,3815,118743,3870,42652,2761,6781,1197,35871,2473,2145,780,73946,3591,40282,2749
6083,31/12/2006,75011,2009,51465,2401,15499,1820,2963,1022,12536,1421,790,427,35176,2477,23546,1786
6085,31/12/2006,354810,6056,275979,5947,86701,3698,17589,2423,69112,3267,6138,1497,183140,5548,78831,3241
6087,31/12/2006,55666,2221,41706,2288,17128,1720,2912,759,14216,1556,663,447,23915,2091,13960,1319
6089,31/12/2006,44889,2165,29380,1966,8598,1306,2062,670,6536,1120,624,336,20158,1826,15509,1434
6095,31/12/2006,90468,3012,76112,3038,25241,2272,8032,1543,17209,1786,1197,539,49674,2739,14356,1372
6097,31/12/2006,114133,3091,83329,3106,26498,2182,5546,1004,20952,2014,2168,897,54663,3070,30804,2310
6099,31/12/2006,102731,3409,79838,3013,22488,1990,9130,1551,13358,1565,907,488,56443,3026,22893,1962
6101,31/12/2006,19526,1348,15127,1457,4337,923,1114,460,3223,861,196,164,10594,1266,4399,690
6107,31/12/2006,72770,2612,53815,2349,10391,1306,2782,686,7609,1154,633,350,42791,2347,18955,1542
6111,31/12/2006,177961,3791,142963,3752,48002,2808,11712,1660,36290,2608,4062,1061,90899,3650,34998,2585
6113,31/12/2006,36338,1546,27712,1639,9167,1321,3093,853,6074,1086,655,519,17890,1445,8626,1030
6115,31/12/2006,13381,1162,9293,1214,2627,862,1363,578,1264,577,195,166,6471,1101,4088,634
6001,31/12/2007,298409,5528,231047,5330,78688,4127,18820,2300,59868,3413,3447,1021,148912,4828,67362,3400
6007,31/12/2007,50554,2046,32463,2187,10050,1476,2280,704,7770,1334,133,127,22280,1905,18091,1675
6013,31/12/2007,260823,4027,207504,4425,70032,3583,16266,1891,53766,3230,3699,897,133773,4579,53319,2633
6017,31/12/2007,48954,1913,38957,2089,14456,1850,3281,1057,11175,1507,1153,567,23348,2460,9997,1056
6019,31/12/2007,157007,3883,115802,4008,29116,2180,9062,1296,20054,1918,2490,951,84196,4030,41205,2207
6023,31/12/2007,30514,1785,17020,1674,4626,865,1799,674,2827,629,94,120,12300,1418,13494,1161
6025,31/12/2007,22774,1899,15608,1806,2047,560,1062,402,985,407,157,132,13404,1729,7166,991
6029,31/12/2007,147822,3929,113124,3773,27896,2090,11236,1732,16660,1864,1587,667,83641,3552,34698,2074
6031,31/12/2007,23535,1440,18414,1522,4113,912,1832,719,2281,611,47,81,14254,1439,5121,795
6033,31/12/2007,16763,1774,9458,1575,2518,843,278,240,2240,792,279,342,6661,1439,7305,1190
6037,31/12/2007,1558468,13095,1201197,13004,338974,7850,92582,4654,246392,7058,29467,2845,832756,10683,357271,7044
6039,31/12/2007,27034,1646,19179,1606,5374,1088,1029,422,4345,1088,361,319,13444,1404,7855,1036
6041,31/12/2007,64824,2754,48764,2647,18714,1844,2315,769,16399,1774,1140,584,28910,2105,16060,1854
6045,31/12/2007,21300,1535,11172,1239,2319,585,703,286,1616,506,0,292,8853,1197,10128,1265
6047,31/12/2007,41790,2430,32201,2277,7814,1340,2851,875,4963,923,460,430,23927,1981,9589,1220
6053,31/12/2007,64807,2875,49020,2896,14708,2123,3890,945,10818,1675,807,480,33505,2742,15787,1606
6055,31/12/2007,32301,1522,23407,1580,8307,1211,1599,552,6708,1108,828,657,14272,1705,8894,1094
6057,31/12/2007,28349,1647,19635,1711,7840,1302,1452,696,6388,1155,0,292,11795,1509,8714,1198
6059,31/12/2007,612493,5755,474371,6181,148290,4736,35011,2918,113279,3581,9624,1615,316457,7123,138122,4094
6061,31/12/2007,89508,2618,67194,2681,25906,2374,7179,1293,18727,2036,1514,597,39774,2186,22314,1767
6065,31/12/2007,452798,6660,348396,6475,103718,4176,41549,3204,62169,2951,5126,1271,239552,5983,104402,3727
6067,31/12/2007,307787,5148,241655,5377,88790,3725,28923,2790,59867,3357,2628,793,150237,4849,66132,2767
6071,31/12/2007,386391,6425,306394,6367,83642,4389,34038,3325,49604,3430,8432,1709,214320,6760,79997,3516
6073,31/12/2007,584243,7869,447396,7654,155117,4497,42180,3510,112937,3857,9727,1560,282552,7415,136847,4639
6075,31/12/2007,121809,4211,88448,3953,25211,2125,5226,1020,19985,1840,2222,782,61015,4057,33361,2337
6077,31/12/2007,131039,4269,100008,4237,32229,2591,10924,1627,21305,2009,1138,487,66641,3528,31031,2049
6079,31/12/2007,59915,2816,42061,2684,15263,1711,3894,1033,11369,1657,636,371,26162,2121,17854,1432
6081,31/12/2007,155617,3522,115367,3518,36311,2606,7586,1309,28725,2241,1865,707,77191,3127,40250,2401
6083,31/12/2007,76420,2216,54610,2295,17114,1822,4345,1013,12769,1499,756,465,36740,2583,21810,1736
6085,31/12/2007,354395,6539,271367,6265,87476,4118,22993,2147,64483,3795,5235,1234,178656,5152,83028,3487
6087,31/12/2007,55748,2309,39666,2351,14668,1605,3074,800,11594,1511,899,476,24099,1969,16082,1386
6089,31/12/2007,44597,2017,30278,2037,9434,1285,2660,782,6774,994,525,414,20319,2081,14319,1393
6095,31/12/2007,90775,2452,73365,2572,24778,2103,8825,1337,15953,1610,1422,620,47165,2527,17410,1514
6097,31/12/2007,110167,2654,79142,2463,26275,2067,6006,1262,20269,1784,1236,552,51631,2675,31025,2040
6099,31/12/2007,100425,3289,76512,2932,22253,2022,8024,1647,14229,1487,1249,550,53010,2749,23913,1922
6101,31/12/2007,20769,1166,14727,1397,4695,854,819,395,3876,795,405,286,9627,1341,6042,835
6107,31/12/2007,72453,2619,52800,2707,11827,1325,4222,1084,7605,1032,685,504,40288,2507,19653,1519
6111,31/12/2007,173223,3236,136390,3578,47944,2816,11199,1555,36745,2420,3713,930,84733,3304,36833,2288
6113,31/12/2007,37899,1790,28580,1600,10091,1260,2863,962,7228,1069,719,418,17770,1728,9319,1190
6115,31/12/2007,13169,1391,9762,1250,3335,1108,1251,678,2084,880,287,268,6140,1016,3407,767
6001,31/12/2008,289188,6710,226724,5625,78698,3969,16752,2112,61946,3834,4694,1138,143332,4976,62464,3248
6007,31/12/2008,49878,2206,32434,2024,9195,1435,1481,527,7714,1246,363,295,22876,1967,17444,1815
6013,31/12/2008,253573,4209,198375,4449,72969,4002,19428,2351,53541,3226,4274,1025,121132,4209,55198,2946
6017,31/12/2008,46505,1804,34175,1929,12929,1587,2732,948,10197,1461,455,299,20791,1927,12330,1446
6019,31/12/2008,149799,4811,113955,3754,26328,2269,8778,1283,17550,1717,3430,1014,84197,3572,35844,2892
6023,31/12/2008,28623,1831,18574,1820,5966,953,1711,608,4255,775,18,31,12590,1639,10049,1118
6025,31/12/2008,25739,1837,16553,1967,2962,707,1456,532,1506,453,172,184,13419,1846,9186,1262
6029,31/12/2008,145468,4122,108875,3883,26055,2411,10192,1800,15863,1689,1142,580,81678,3808,36593,2435
6031,31/12/2008,22409,1676,16612,1820,4106,1071,1575,686,2531,751,488,526,12018,1526,5797,1084
6033,31/12/2008,15574,1835,9981,1466,2853,887,928,423,1925,798,359,618,6769,1251,5593,1159
6037,31/12/2008,1528562,13153,1178111,13787,352553,8163,100520,4873,252033,5902,24995,2866,800563,13070,350451,8218
6039,31/12/2008,24974,1866,18166,2005,3984,1111,1714,661,2270,830,191,141,13991,1780,6808,1002
6041,31/12/2008,66339,2622,50025,2776,19616,1810,3068,835,16548,1783,934,505,29475,2438,16314,1881
6045,31/12/2008,21170,1695,11401,1449,2198,592,560,370,1638,496,143,145,9060,1312,9769,1281
6047,31/12/2008,38502,2103,27964,1924,5865,956,2510,736,3355,616,782,563,21317,2055,10538,1166
6053,31/12/2008,65439,2763,47326,2750,14110,1717,3627,924,10483,1562,1206,590,32010,2557,18113,1786
6055,31/12/2008,30047,1952,20740,1954,8255,1022,2198,620,6057,951,173,181,12312,1630,9307,1180
6057,31/12/2008,29176,1783,18889,1542,6588,1081,1167,472,5421,979,118,158,12183,1381,10287,1236
6059,31/12/2008,592946,6891,462290,7294,155228,5653,33861,2740,121367,4792,6668,1284,300394,6139,130656,5043
6061,31/12/2008,93935,2467,70780,2858,29902,2515,9398,1425,20504,1954,570,297,40308,3094,23155,1841
6065,31/12/2008,438193,7265,335984,7413,104440,4510,41516,3140,62924,3214,5204,1180,226340,7236,102209,3668
6067,31/12/2008,297912,5728,235253,5136,84344,4032,27944,2599,56400,3485,4079,1166,146830,4563,62659,3101
6071,31/12/2008,365279,6911,288220,6704,85097,4711,32929,2544,52168,3902,6457,1191,196666,5906,77059,3596
6073,31/12/2008,585307,7571,451087,7543,160482,4926,45975,3204,114507,3883,8552,1669,282053,7765,134220,5093
6075,31/12/2008,127625,4686,95909,4044,30337,2347,6559,1150,23778,2185,2420,1085,63152,3683,31716,2598
6077,31/12/2008,121162,4667,93087,3485,31539,2493,11533,1736,20006,1970,1915,791,59633,2922,28075,3866
6079,31/12/2008,63686,2700,44833,2605,14556,1727,2834,787,11722,1594,427,388,29850,2312,18853,1668
6081,31/12/2008,154221,4114,114888,3808,40097,2893,8361,1233,31736,2732,1327,566,73464,3806,39333,2557
6083,31/12/2008,75128,2751,53505,2648,16588,1990,4090,995,12498,1577,629,352,36288,2862,21623,1857
6085,31/12/2008,355181,6145,274843,6206,91212,4771,21077,2854,70135,3760,4441,1232,179190,5413,80338,4087
6087,31/12/2008,55999,1812,41907,2115,15333,1554,2767,831,12566,1320,154,167,26420,2104,14092,1391
6089,31/12/2008,45629,2248,29867,1937,9807,1474,3551,1051,6256,1239,356,323,19704,1884,15762,1274
6095,31/12/2008,86980,2938,69311,2685,25108,2004,7434,1207,17674,1696,1273,507,42930,2677,17669,1519
6097,31/12/2008,115000,2667,85015,2918,30209,2278,7438,1306,22771,2085,1234,456,53572,2935,29985,1958
6099,31/12/2008,100049,3247,75225,3015,20418,2117,8283,1418,12135,1572,2512,873,52295,2811,24824,1985
6101,31/12/2008,18696,1304,14094,1236,4582,938,2082,739,2500,662,95,117,9417,1076,4602,735
6107,31/12/2008,73086,2860,53336,3079,14348,1940,5823,1160,8525,1297,346,227,38642,3018,19750,1567
6111,31/12/2008,170236,4023,134492,4012,47894,3243,14319,2080,33575,2399,4456,1118,82142,4254,35744,1965
6113,31/12/2008,36711,2253,27506,2021,9345,1328,2363,641,6982,1099,260,214,17901,1615,9205,1319
6115,31/12/2008,14673,1368,11137,1459,3067,743,1417,643,1650,500,203,248,7867,1355,3536,758
6001,31/12/2009,280221,4710,218017,4452,65993,3498,16685,2275,49308,2877,3353,890,148671,4380,62204,2812
6007,31/12/2009,51838,2164,33434,2418,9843,1460,2961,839,6882,1280,229,200,23362,2283,18404,1926
6013,31/12/2009,247333,4879,192553,4331,65095,4036,15527,2429,49568,3359,2799,867,124659,3970,54780,2619
6017,31/12/2009,51393,2223,38395,2457,13010,1915,4540,1446,8470,1299,1113,629,24272,2403,12998,1515
6019,31/12/2009,152504,3738,113831,3713,24589,2081,7350,1176,17239,1804,2085,751,87157,3452,38673,2831
6023,31/12/2009,29092,1375,17437,1246,5173,878,839,320,4334,826,279,268,11985,1187,11655,1168
6025,31/12/2009,28596,1824,19459,1714,4070,888,2125,727,1945,661,421,318,14968,1641,9137,1065
6029,31/12/2009,145330,4194,108854,3815,24911,2185,11149,1612,13762,1492,1387,463,82556,3747,36476,2327
6031,31/12/2009,19582,1515,14752,1799,2815,652,1354,480,1461,478,140,143,11797,1786,4830,813
6033,31/12/2009,17747,1681,11323,1714,3371,1034,1442,670,1929,872,366,391,7586,1345,6424,1259
6037,31/12/2009,1514362,13749,1175417,13096,334575,8064,99699,5311,234876,6640,23672,2635,817170,11713,338945,7612
6039,31/12/2009,27746,1856,19812,1656,5072,1203,1044,565,4028,1158,83,142,14657,1940,7934,1122
6041,31/12/2009,63046,2716,45528,2528,18538,1938,2617,702,15921,1862,377,269,26613,2200,17518,1844
6045,31/12/2009,21021,1480,12144,1284,2279,631,569,311,1710,527,300,225,9565,1269,8877,1098
6047,31/12/2009,39947,2316,28925,2019,6280,1080,2172,753,4108,779,179,176,22466,1920,11022,1284
6053,31/12/2009,64565,2566,47723,2672,11988,1500,3060,862,8928,1238,1091,646,34644,2499,16842,1708
6055,31/12/2009,31298,1867,21686,1875,6538,1197,1776,701,4762,1015,466,309,14682,1670,9612,1248
6057,31/12/2009,30320,1892,20909,1897,6330,1199,1201,646,5129,925,204,204,14375,1709,9411,1243
6059,31/12/2009,586937,7024,445966,7693,142272,5187,33441,2988,108831,4059,11394,1878,292300,6755,140971,5213
6061,31/12/2009,90529,2281,68275,2725,23089,1960,6614,1377,16475,1554,1030,518,44156,2683,22254,1755
6065,31/12/2009,440246,6338,330966,6996,89136,3796,36055,3210,53081,3348,6269,1340,235561,6525,109280,3435
6067,31/12/2009,292581,5267,224531,5432,68669,3425,25349,2278,43320,2540,2714,852,153148,4779,68050,2906
6071,31/12/2009,377587,6460,296549,6117,72218,3841,28401,3028,43817,3103,5368,1442,218963,5626,81038,3703
6073,31/12/2009,578787,7201,443139,7620,138928,5318,38372,2872,100556,4479,8541,1450,295670,6469,135648,4409
6075,31/12/2009,122182,4247,87651,3799,25353,2356,4735,1033,20618,2247,1210,574,61088,3441,34531,2724
6077,31/12/2009,126980,5361,97311,4553,27087,2429,9419,1682,17668,1952,953,524,69271,4139,29669,2233
6079,31/12/2009,63780,2394,43996,2461,12343,1635,2963,1170,9380,1207,1354,712,30299,2354,19784,1662
6081,31/12/2009,153416,4043,115966,4114,38906,2669,7478,1396,31428,2441,1531,718,75529,3385,37450,2353
6083,31/12/2009,74286,2605,51322,2743,15649,1662,3523,941,12126,1365,516,284,35157,2845,22964,1820
6085,31/12/2009,344935,6086,262070,5783,85813,3963,20458,1947,65355,3707,5851,1237,170406,5372,82865,4112
6087,31/12/2009,56015,2417,39787,2126,13354,1514,2965,773,10389,1274,785,439,25648,1894,16228,1769
6089,31/12/2009,44976,1870,29180,1950,8513,1234,2291,622,6222,1022,551,275,20116,1979,15796,1311
6095,31/12/2009,91324,2797,72794,3101,22878,2186,7591,1277,15287,1637,1075,504,48841,2765,18530,1703
6097,31/12/2009,109437,3969,80798,3614,28403,2248,7995,1462,20408,1883,1255,653,51140,3065,28639,1889
6099,31/12/2009,96132,3720,69828,3305,17790,2114,5904,1219,11886,1659,1037,545,51001,2994,26304,2059
6101,31/12/2009,19642,1373,14940,1313,4629,1077,2039,691,2590,837,346,280,9965,1243,4702,919
6107,31/12/2009,72208,2486,54057,2674,11927,1652,4118,1049,7809,1312,742,412,41388,2454,18151,1598
6111,31/12/2009,169308,3738,134239,3984,44089,2800,11803,1539,32286,2616,2805,928,87345,3880,35069,2576
6113,31/12/2009,37805,1579,28664,1754,7836,1230,2876,939,4960,823,238,206,20590,1748,9141,1159
6115,31/12/2009,15321,1323,10970,1436,2743,787,1021,493,1722,588,0,294,8227,1439,4351,726
6001,31/12/2010,286780,5237,220712,5421,63716,3277,14296,1819,49420,3078,3205,984,153791,5455,66068,3121
6007,31/12/2010,50325,2185,32399,1937,7664,1386,1799,627,5865,1275,537,312,24198,1953,17926,1690
6013,31/12/2010,243026,4695,190759,4999,59698,3292,15940,2134,43758,2618,3515,965,127546,4534,52267,2359
6017,31/12/2010,51155,2734,38534,2558,12705,1440,3116,948,9589,1318,377,223,25452,2405,12621,1644
6019,31/12/2010,154283,4108,114058,3926,23654,2430,7077,1369,16577,1926,1283,630,89121,3782,40225,2544
6023,31/12/2010,31560,1850,19980,1704,4563,780,1213,490,3350,729,252,210,15165,1714,11580,1518
6025,31/12/2010,27947,1648,19051,1668,3546,932,1713,702,1833,601,171,217,15334,1489,8896,1425
6029,31/12/2010,148939,3532,107754,3173,20118,1696,7691,1266,12427,1322,1696,717,85940,3165,41185,2650
6031,31/12/2010,20953,1516,15174,1561,2540,646,1054,421,1486,484,307,241,12327,1486,5779,892
6033,31/12/2010,15970,1551,10260,1453,2162,811,1401,681,761,388,88,118,8010,1346,5710,1043
6037,31/12/2010,1501448,14839,1156155,13900,290242,7624,83991,4304,206251,6795,22383,2862,843530,12310,345293,8511
6039,31/12/2010,25469,1872,19077,1561,4392,1013,1269,644,3123,736,143,159,14542,1621,6392,1034
6041,31/12/2010,66429,2772,50006,2790,17193,1969,2220,746,14973,1714,730,481,32083,2564,16423,1535
6045,31/12/2010,18318,1755,9932,1471,1843,606,608,383,1235,449,52,88,8037,1385,8386,1394
6047,31/12/2010,40334,2510,29786,2501,5038,938,1819,650,3219,815,285,246,24463,2456,10548,1444
6053,31/12/2010,63894,2982,45014,2797,10764,1461,2315,782,8449,1308,687,301,33563,2427,18880,2216
6055,31/12/2010,30948,1999,21906,2062,5285,1045,1111,547,4174,914,330,261,16291,1886,9042,1313
6057,31/12/2010,28278,1771,19471,1427,6360,1177,1580,640,4780,986,215,212,12896,1533,8807,1376
6059,31/12/2010,584314,7164,444114,7163,125051,4246,30472,2634,94579,3756,6312,1395,312751,6316,140200,4249
6061,31/12/2010,93350,3170,71114,3328,21633,2116,8204,1723,13429,1562,695,390,48786,3185,22236,1817
6065,31/12/2010,458273,6812,349306,6591,79128,3732,28665,2752,50463,3149,3754,975,266424,7229,108967,4454
6067,31/12/2010,294365,5847,225690,5377,59701,3251,22255,2008,37446,2851,4022,986,161967,4759,68675,3628
6071,31/12/2010,372535,7382,285972,7416,68553,4310,28382,2969,40171,3306,3948,1176,213471,7125,86563,3906
6073,31/12/2010,572400,8785,438814,7546,116336,4761,31907,2892,84429,3803,7525,1458,314953,7364,133586,5311
6075,31/12/2010,123128,4317,84904,3824,23366,2201,5562,1080,17804,2029,998,572,60540,3538,38224,2719
6077,31/12/2010,124244,4141,96709,3796,24704,2713,8817,1581,15887,1963,1174,614,70831,3702,27535,2342
6079,31/12/2010,59862,2141,41224,2274,10585,1286,2217,740,8368,1252,863,507,29776,2145,18638,1838
6081,31/12/2010,152358,4237,113945,4257,35705,2528,7662,1416,28043,2062,1484,605,76756,3674,38413,2354
6083,31/12/2010,75146,2601,51962,2501,16278,1603,4931,1011,11347,1300,678,409,35006,2127,23184,1667
6085,31/12/2010,342955,4963,256276,5674,77684,3700,15803,2143,61881,3096,5485,1380,173107,5623,86679,3495
6087,31/12/2010,54209,3225,39258,3199,12305,1436,2268,794,10037,1432,1317,635,25636,2573,14951,1508
6089,31/12/2010,44695,2085,29421,2099,8854,1195,3118,927,5736,1022,421,278,20146,1894,15274,1550
6095,31/12/2010,87615,2945,67552,3341,19118,2243,5419,1050,13699,1720,807,429,47627,3148,20063,1495
6097,31/12/2010,110953,3114,78737,3222,22974,1982,6053,1418,16921,1553,1054,600,54709,3474,32216,2362
6099,31/12/2010,98598,3087,74469,3146,15225,1858,5430,1124,9795,1569,1148,575,58096,3182,24129,1958
6101,31/12/2010,17958,1234,12676,1240,4474,914,1872,743,2602,749,125,136,8077,1139,5282,951
6107,31/12/2010,75913,2391,54406,2597,10887,1491,4723,1146,6164,1116,482,329,43037,2522,21507,1851
6111,31/12/2010,170124,4279,129346,4108,38247,2363,10436,1610,27811,1930,1525,592,89574,3764,40778,2570
6113,31/12/2010,37863,2183,27412,2175,7862,1366,2839,819,5023,978,688,537,18862,2006,10451,1252
6115,31/12/2010,14982,1451,10881,1181,2441,655,823,465,1618,571,121,148,8319,1209,4101,928
6001,31/12/2011,289222,5684,222697,5513,52485,3323,12448,1761,40037,2745,4076,1029,166136,4698,66525,3269
6007,31/12/2011,48746,2448,31909,2586,7532,1225,2327,754,5205,1075,100,120,24277,2465,16837,1758
6013,31/12/2011,246590,5513,190712,5751,47123,3772,9706,1681,37417,3042,3681,1656,139908,5540,55878,3863
6017,31/12/2011,48985,2549,36227,2414,10395,1537,3173,971,7222,1346,488,332,25344,2352,12758,1527
6019,31/12/2011,155609,4439,114643,4274,18138,1665,6425,1394,11713,1527,2033,825,94472,4339,40966,2656
6023,31/12/2011,28459,1875,17122,1643,4151,1021,625,353,3526,946,501,391,12470,1508,11337,1180
6025,31/12/2011,27172,1553,19365,1523,2974,904,1448,706,1526,539,283,289,16108,1544,7807,1103
6029,31/12/2011,144094,4352,104141,4124,18916,2021,7397,1326,11519,1644,913,549,84312,3861,39953,2587
6031,31/12/2011,22822,1448,16974,1521,3466,792,1881,699,1585,564,202,245,13306,1463,5848,891
6033,31/12/2011,16839,1362,9855,1411,2116,726,1447,683,669,381,53,90,7686,1418,6984,1069
6037,31/12/2011,1482011,12100,1126864,11396,260666,7749,73860,4178,186806,5976,19722,2689,846476,9968,355147,8018
6039,31/12/2011,24738,1996,16427,1984,3423,1051,846,482,2577,825,91,109,12913,1629,8311,1049
6041,31/12/2011,60453,2759,43474,2667,13900,1806,2377,855,11523,1727,200,174,29374,2278,16979,1497
6045,31/12/2011,20447,1648,11224,1578,2663,761,450,233,2213,760,37,64,8524,1529,9223,1306
6047,31/12/2011,38880,2463,28126,2290,3856,936,1237,481,2619,805,195,149,24075,2356,10754,1144
6053,31/12/2011,58668,2648,41893,2536,8073,1257,1886,558,6187,1108,906,626,32914,2554,16775,1494
6055,31/12/2011,27183,1774,19241,1788,4996,894,1573,479,3423,804,192,173,14053,1771,7942,1003
6057,31/12/2011,30219,2173,21607,2023,6100,1208,1915,858,4185,1122,102,126,15405,1815,8612,1050
6059,31/12/2011,581991,6072,443304,6618,107018,4402,23386,2316,83632,3353,6227,1023,330059,7191,138687,3984
6061,31/12/2011,94614,3282,70800,3486,17923,2380,6553,1471,11370,1783,64,104,52813,3493,23814,2215
6065,31/12/2011,451415,7857,337651,8577,68326,4665,24987,3454,43339,3252,5228,1943,264097,8498,113764,5528
6067,31/12/2011,286161,6945,217036,6261,47605,3321,15352,1631,32253,2983,2064,731,167367,6125,69125,3670
6071,31/12/2011,381133,7803,292309,7745,59712,4930,20247,3151,39465,3917,3642,1126,228955,7609,88824,4403
6073,31/12/2011,565447,6512,427532,6778,104062,4275,26148,2510,77914,3478,6058,1776,317412,6992,137915,4071
6075,31/12/2011,123681,4286,87602,4114,20219,2077,3614,857,16605,1896,1019,414,66364,3980,36079,2878
6077,31/12/2011,124893,3875,92654,3663,18646,2308,7405,1781,11241,1632,1860,745,72148,3915,32239,2262
6079,31/12/2011,56773,2117,37595,1951,7973,1075,1551,486,6422,1022,291,212,29331,2141,19178,1592
6081,31/12/2011,150930,3851,111295,3709,29675,2332,5879,1270,23796,1835,1910,712,79710,3380,39635,2154
6083,31/12/2011,71387,2527,49518,2347,12235,1240,3098,846,9137,1048,640,426,36643,2246,21869,1656
6085,31/12/2011,343742,4867,257329,5700,65432,3554,11684,1753,53748,2914,3335,1067,188562,5117,86413,4469
6087,31/12/2011,54319,2402,38380,2463,12351,1735,2059,605,10292,1656,459,387,25570,2288,15939,1488
6089,31/12/2011,45256,1976,28355,2012,5274,1045,1663,573,3611,794,333,269,22748,1754,16901,1352
6095,31/12/2011,85648,3209,65924,3447,16064,1727,5447,1309,10617,1333,1190,587,48670,3021,19724,1713
6097,31/12/2011,107486,3552,77308,3439,20837,2017,5128,1115,15709,1801,1248,572,55223,3210,30178,2366
6099,31/12/2011,97147,3225,70083,3299,11714,1458,3959,1010,7755,1277,667,380,57702,3533,27064,2203
6101,31/12/2011,19872,1433,14799,1495,2461,701,823,449,1638,546,167,175,12171,1497,5073,874
6107,31/12/2011,76347,2682,55841,2960,8578,1569,2913,927,5665,1167,533,344,46730,2896,20506,1662
6111,31/12/2011,173534,3760,137331,3697,37375,2270,9740,1601,27635,1989,1885,700,98071,3604,36203,2407
6113,31/12/2011,37802,2312,28085,2016,7856,1600,3563,1121,4293,1109,231,225,19998,1671,9717,1290
6115,31/12/2011,13324,1267,9935,1271,1749,581,791,432,958,416,340,311,7846,1309,3389,806
6001,31/12/2012,286205,5284,216631,5040,49547,2341,12190,1555,37357,2040,3093,861,163991,4290,69574,2779
6007,31/12/2012,50752,2105,32873,1951,7083,1137,2051,750,5032,955,369,259,25421,1775,17879,1548
6013,31/12/2012,244208,4892,188950,4823,45609,3315,9760,1717,35849,2725,1993,653,141348,5094,55258,2983
6017,31/12/2012,47733,1998,34327,2028,8172,1168,2006,712,6166,988,360,287,25795,1677,13406,1223
6019,31/12/2012,150354,3479,108864,3381,17313,1987,7165,1281,10148,1327,1519,642,90032,3650,41490,2673
6023,31/12/2012,28072,1613,18483,1623,3559,756,865,386,2694,644,101,123,14823,1492,9589,1137
6025,31/12/2012,26517,1836,16895,1759,2445,806,1048,452,1397,632,56,102,14394,1740,9622,1292
6029,31/12/2012,147900,3817,106199,3836,13283,1548,6458,1437,6825,928,1022,492,91894,3929,41701,2502
6031,31/12/2012,19777,1547,14255,1299,2509,725,1035,460,1474,550,235,208,11511,1110,5522,855
6033,31/12/2012,15542,1557,9536,1552,1414,574,685,409,729,435,137,155,7985,1342,6006,1050
6037,31/12/2012,1481122,11896,1121835,11313,224801,5567,59945,3145,164856,4744,13172,1530,883862,9960,359287,6574
6039,31/12/2012,24555,1669,16709,1707,2399,504,636,273,1763,430,64,113,14246,1644,7846,1074
6041,31/12/2012,63948,2193,45388,2349,13183,1765,2172,803,11011,1592,1059,554,31146,2130,18560,1638
6045,31/12/2012,18959,1278,10067,1151,1550,483,311,219,1239,446,0,197,8517,1232,8892,1049
6047,31/12/2012,40931,2532,30195,2247,4263,960,771,323,3492,914,247,153,25685,2303,10736,1221
6053,31/12/2012,60584,2594,43257,2585,7796,1139,1399,481,6397,1040,284,163,35177,2231,17327,1522
6055,31/12/2012,29220,1412,20187,1523,5900,1038,2080,817,3820,657,414,353,13873,1395,9033,884
6057,31/12/2012,29567,1721,18485,1590,4256,937,712,326,3544,891,205,221,14024,1429,11082,1282
6059,31/12/2012,565956,6120,421483,6179,96785,4125,20982,2440,75803,3506,4042,878,320656,6492,144473,4170
6061,31/12/2012,92455,2507,68641,2926,16207,1652,4105,900,12102,1427,527,288,51907,3199,23814,1876
6065,31/12/2012,442164,7580,325771,7640,57489,3272,20834,2270,36655,2411,2666,732,265616,6851,116393,4057
6067,31/12/2012,289227,4852,221612,4903,44245,2614,13596,1923,30649,2399,1567,611,175800,4855,67615,2866
6071,31/12/2012,360060,6921,274681,6021,49616,2899,18413,1831,31203,2362,2960,1135,222105,5996,85379,3542
6073,31/12/2012,573530,6642,429578,7221,96593,4734,24238,2753,72355,3693,5253,1348,327732,8005,143952,4180
6075,31/12/2012,124739,4592,88407,3872,21142,2127,5137,1364,16005,1744,794,401,66471,3678,36332,2646
6077,31/12/2012,121799,3621,89083,3470,14713,1515,5115,1127,9598,1128,1457,693,72913,3278,32716,2200
6079,31/12/2012,56105,2277,37533,2272,8679,1323,1587,594,7092,1182,200,159,28654,2144,18572,1472
6081,31/12/2012,148728,3608,107218,3665,29195,2169,5021,1048,24174,1798,910,404,77113,3308,41510,2234
6083,31/12/2012,73176,2449,49835,2294,10738,1366,2449,671,8289,1142,659,359,38438,2301,23341,1847
6085,31/12/2012,344484,5421,255233,5805,59153,3010,12083,1390,47070,2707,5496,1459,190584,4999,89251,3675
6087,31/12/2012,52900,2407,38681,2537,10741,1459,2047,654,8694,1393,254,148,27686,2154,14219,1393
6089,31/12/2012,42265,1908,27251,1663,5216,844,1370,475,3846,719,252,248,21783,1524,15014,1123
6095,31/12/2012,83408,2784,64835,2634,14383,1389,3993,989,10390,1192,919,441,49533,2549,18573,1508
6097,31/12/2012,110476,3322,80697,2928,20264,2107,5294,1132,14970,1646,1199,483,59234,2616,29779,1878
6099,31/12/2012,93081,2911,69968,2826,14220,1575,5371,1152,8849,1203,669,396,55079,2956,23113,1490
6101,31/12/2012,18517,1200,12778,1307,2517,654,1013,478,1504,490,120,133,10141,1273,5739,839
6107,31/12/2012,75044,2700,52061,2960,8034,1329,3143,851,4891,917,458,314,43569,2988,22983,2086
6111,31/12/2012,172028,3950,133540,3838,29466,2131,7034,1233,22432,1875,1290,603,102784,4155,38488,1963
6113,31/12/2012,35683,1960,25818,1717,5535,1026,2172,765,3363,669,430,402,19853,1519,9865,1178
6115,31/12/2012,14671,1122,10375,1159,1308,458,574,302,734,405,0,197,9067,1085,4296,856
6001,31/12/2013,288417,4698,217870,4957,43884,2396,9779,1362,34105,2250,2775,753,171211,4956,70547,3073
6007,31/12/2013,48961,2379,30662,1997,5509,1012,1109,414,4400,905,307,257,24846,1831,18299,1689
6013,31/12/2013,247289,4837,182194,4683,40096,2405,7350,1197,32746,2274,2483,766,139615,4517,65095,3483
6017,31/12/2013,48749,2157,34055,2077,7456,1092,1209,582,6247,1055,609,426,25990,1942,14694,1660
6019,31/12/2013,152766,3755,108751,3449,14989,1567,5327,1082,9662,1125,1195,593,92567,3676,44015,2856
6023,31/12/2013,28950,1391,17226,1397,3756,960,883,448,2873,860,0,203,13470,1381,11724,1064
6025,31/12/2013,25644,2032,15947,1862,1886,687,823,621,1063,428,63,129,13998,1785,9697,1243
6029,31/12/2013,137511,4443,96246,3999,14564,1682,6037,1441,8527,1172,532,455,81150,3804,41265,2691
6031,31/12/2013,21090,1578,14699,1460,2039,625,1063,484,976,505,317,222,12343,1451,6391,992
6033,31/12/2013,16595,1322,10145,1396,1494,623,460,333,1034,576,51,83,8600,1390,6450,1099
6037,31/12/2013,1477894,14280,1097561,13495,196221,4969,49084,2946,147137,4283,10165,1514,891175,11446,380333,6735
6039,31/12/2013,25570,1786,17072,1785,2465,756,1164,584,1301,485,42,71,14565,1645,8498,1102
6041,31/12/2013,67526,2327,48916,2497,14961,1710,1803,655,13158,1545,580,410,33375,2348,18610,1717
6045,31/12/2013,19271,1571,11236,1519,2256,744,752,507,1504,585,267,222,8713,1400,8035,1173
6047,31/12/2013,40650,2025,27417,1987,2953,571,1308,417,1645,532,8,14,24456,1850,13233,1407
6053,31/12/2013,61919,2274,42942,2515,7909,1046,1639,561,6270,957,208,140,34825,2507,18977,1407
6055,31/12/2013,29568,1564,21978,1439,5102,780,963,361,4139,692,339,240,16537,1288,7590,1081
6057,31/12/2013,28215,1601,18435,1515,2802,846,532,306,2270,802,336,332,15297,1434,9780,1460
6059,31/12/2013,577242,6926,423346,6902,86633,4598,17846,1908,68787,4143,5585,1741,331128,6739,153896,4878
6061,31/12/2013,92391,2806,68275,2837,12831,1490,3571,896,9260,1166,276,201,55168,2873,24116,1678
6065,31/12/2013,442179,7433,325105,7712,47936,2777,17201,1955,30735,2287,2955,1013,274214,7843,117074,4306
6067,31/12/2013,282206,5311,210444,5965,36126,2657,11554,1235,24572,2212,1757,655,172561,5422,71762,3428
6071,31/12/2013,361591,5248,266470,5361,40104,2936,13552,1866,26552,2440,2899,900,223467,5651,95121,3678
6073,31/12/2013,576985,6112,426725,7595,81274,4527,19153,2313,62121,4132,5777,1735,339674,7122,150260,4992
6075,31/12/2013,127211,4092,86276,3943,20172,2200,4120,1274,16052,1824,693,326,65411,3705,40935,2193
6077,31/12/2013,119716,3216,86166,3549,14843,1719,3787,932,11056,1611,1402,516,69921,3229,33550,2217
6079,31/12/2013,59488,2158,40001,2386,8145,1347,1477,551,6668,1305,279,280,31577,2175,19487,1645
6081,31/12/2013,156006,3266,112831,3412,25538,2166,4547,969,20991,1854,1555,840,85738,3595,43175,2158
6083,31/12/2013,73083,2839,49627,2754,9509,1309,2900,856,6609,1143,269,211,39849,2549,23456,2207
6085,31/12/2013,346701,5514,250638,5458,53194,2983,10487,1539,42707,2610,2922,1003,194522,5463,96063,3315
6087,31/12/2013,56426,2450,39692,2395,8938,1330,1156,574,7782,1168,166,140,30588,2355,16734,1522
6089,31/12/2013,42681,1855,27536,1823,4146,827,1520,563,2626,599,232,203,23158,1740,15145,1476
6095,31/12/2013,84317,3067,63996,3008,12424,1698,4447,1147,7977,1450,481,300,51091,2815,20321,1815
6097,31/12/2013,110682,3513,77932,3300,17144,1975,3461,1139,13683,1818,660,450,60128,3512,32750,2215
6099,31/12/2013,94674,2732,69062,2864,9393,1353,3281,1011,6112,1042,1958,899,57711,2718,25612,1791
6101,31/12/2013,18772,1353,12955,1422,2582,637,1244,504,1338,443,42,63,10331,1222,5817,923
6107,31/12/2013,70872,2878,50936,2980,7103,1394,2009,672,5094,1305,717,591,43116,2661,19936,1766
6111,31/12/2013,168134,3661,127156,3490,28066,2375,6547,1146,21519,1960,1445,540,97645,3619,40978,2562
6113,31/12/2013,34816,1715,24845,1781,4710,938,1695,579,3015,710,194,167,19941,1574,9971,1269
6115,31/12/2013,14230,1178,9869,1344,1249,508,681,461,568,268,192,248,8428,1352,4361,953
